D39551393B
96E916C6C2
AF96EFFF96
AFC5157FAB
AFFFAFFFAA
C53FAFD52A
B96FAFFFC2
AA9385393A
AC2AC7AAAA
C544556EC6

0, 1
5, 8
SSSSEESWSSESEEEENNWWSE